-------------------------------------101-------------------------------------
-------------------------------------101-------------------------------------
-------------------------------------101-------------------------------------
-----------1111111111111111111111111110111111111111111111111111111-----------
-----------100000000000000000B000000000000000000000000000000000001-----------
-----------1011111011111111111110111110111111011111111111110111101-----------
-----------101---101-----------101---101----101-----------101--101-----------
-----------1011111011111111111110111110111111011111111111110111101-----------
-----------100000000000000000000000000C000000000000000000000000001-----------
11111111111101101111111011111111111111111110111111111111111111110111111111111
000000000000000A000000000000000000000000000000000000000000000000B000000000000
11111011111111111111111110111111111111011111111110111111111111111111110111111
----101-----------------101----------101--------101------------------101-----
----101-----------------101----------1D1--------101------------------101-----
----10111111111111111111101111111111110111111111101111111111111111111101-----
----100C0000000000B00000000000000000000000000000000000000000A0000D000001-----
----1111111101111110111111101111111111*111111111011111110111111101111111-----
-----------101----101-----101--------1*1-------101-----101-----101-----------
-----------101----101-----101----11111*1111----101-----101-----101-----------
11111111111101----101-----101----1********1----101-----101-----10111111111111
0000D000000001----101-----101----1********1----101-----101-----10000000000000
11111111111101----101-----101----1111111111----101-----101-----10111111111111
-----------101----101-----101------------------101-----101-----101-----------
----1111111101111110111111101111111111111111111101111111011111110111111111111
----1000000000C00000000000000000000000000000000A0000000000000000000000001----
----101111111111111111111101111111111101111111111011111111111111111111101----
----101------------------101---------101--------101-------------------101----
----101------------------101---------101--------101-------------------101----
11111011111111111111111111011111111111011111111110111111111111111111111011111
0000000000000000000000000000000000000000000A00000000000000000D000000000000000
11111111111101111111111011111111111111111110111111111101111111110111111111111
-----------100000000000000000000000000000000D000000000000000000001-----------
-----------1011111011111111111101111110111111011111111111101111101-----------
-----------101---101----------101----101----1011---------101---101-----------
-----------1011111011111111111101111110111111011111111111101111101-----------
-----------100000000B000000000000000000000000000000000000000000001-----------
-----------111111111111111111111111111C111111111111111111111111111-----------
-------------------------------------101-------------------------------------
-------------------------------------101-------------------------------------
-------------------------------------101-------------------------------------